#################################
#S    #       #           #    ##
### ## ##### # # ####### ##### ##
#   # ##      #       #       # #
# # ####### ##### # # ######### #
# #       #       # #         # #
# ####### ######### ### ##### # #
#       # #         #   #   # # #
##### # # # ####### ####### # # #
#     # # # #         #     # # #
# ####### # # ####### # ##### # #
#   #     # #  E    # #       # #
# # # ##### ####### # ####### # #
# # #                 #         #
# # ########### ####### #########
#                               #
#################################
